1000000000000000000000001
1000000000000000000000001
1222200000000000000022221
1000000000000000000000001
1000000000000000000000001
1000000222222222220000001
1000002000000000002000001
1000000000000000000000001
1000000000000000000000001
1222200000000000000022221
1000020000000000000200001
1000000000000000000000001
1000000022222222200000001
1000000200000000020000001
1000000000000000000000001
1000020000000000000200001
1a000200000000000002000b1
1111111111111111111111111
