0000000000022000000000000
0000000000022000000000000
0000000000000000000000000
0a00000000022000000000b00
0111110000000000001111100
0000001000000000010000000
0000000000000000000000000
0000000000000000000000000
0000000002222220000000000
0000000000000000000000000
0022222000000000022222000
0000000000000000000000000
0000000011111111000000000
0000000000000000000000000
0000000000000000000000000
0000000000000000000000000
0000000000000000000000000
0000000000000000000000000
