0000000000000000000000000
0000000000000000000000000
0000000000000000000000000
0000000000000000000000000
0000000000000000000000000
0000000000000000000000000
0000000222222222220000000
0000000000000000000000000
0111000000000000000001110
0000000000000000000000000
0000000222222222220000000
0000000000000000000000000
0000000000000000000000000
0a000100000000000001000b0
0111100000000000000011110
0000000222222222220000000
0000000000000000000000000
0000000000000000000000000
