20a0000000000000000000b02
2000000000000000000000002
2000000000000000000000002
2000000000000000000000002
2000000000000000000000002
2000000000000000000000002
2000000000000000000000002
2000000000000000000000002
2011111100000000000000002
2000000000000000111111002
2000000001000000000000002
2000000000111100000000002
2000000000000010000000002
2000000000000000000000002
2000000000000000011111112
2000000000000110000000002
2000000000000000000000002
2222222222222222222222222
