1111111111111111111111111
1000000000000000000000001
1000000000000000000000001
1000000022222220000000001
1000000000000000000000001
1000000000000000000000001
1000022222222222220000001
1000000000000000000000001
100a00000000000000000b001
1222200000000000000222221
1000000000000000000000001
1000000000000000000000001
1000000000000222220000001
1000000000000000000000001
1000002222222000000000001
1000000000000000000000001
1000000000000000000000001
1111111111111111111111111
