2000000000000000000000002
2000000000000000000000002
2000000000000000000000002
2000000000000000000000002
2000000000000000000000002
2000000000000000000000002
2000000000000000000000002
2000000000000000000000002
2000000000000000000000002
2000000000000000000000002
2000000000000000000000002
2000000000000000000000002
2001111110000000111111002
2000000001000001000000002
2000000000000000000000002
2000000000001000000000002
2a000000000111000000000b2
2222222222222222222222222
